7 8
1 1 1 1 1 1 1
1 5 5 5 5 5 1
1 5 3 2 3 5 1
1 5 2 3 2 5 1
1 5 3 2 3 5 1
1 5 2 3 2 5 1
1 5 5 9 5 5 1
1 1 1 1 1 1 1