6 7
1 1 1 1 1 4
1 5 5 5 1 4
1 3 3 3 1 4
1 2 2 2 1 1
1 5 5 5 5 1
1 5 9 5 5 1
1 1 1 1 1 1