8 6
1 1 1 1 1 1 1 1
1 3 5 5 5 5 5 1
1 5 3 2 2 2 9 1
1 3 5 5 5 5 5 1
1 1 1 1 1 5 5 1
4 4 4 4 1 1 1 1