7 9
1 1 1 1 4 4 4
1 3 5 1 1 4 4
1 3 9 5 1 4 4
1 3 5 2 1 4 4
1 1 2 5 1 1 1
4 1 5 2 5 5 1
4 1 5 5 5 5 1
4 1 5 5 1 1 1
4 1 1 1 1 4 4