10 8
4 1 1 1 1 4 4 4 4 4
4 1 5 5 1 1 1 1 4 4
4 1 5 5 5 5 5 1 1 4
1 1 5 1 1 5 5 5 1 4
1 3 5 3 1 5 9 2 1 1
1 5 5 5 1 5 2 2 5 1
1 5 5 3 1 5 5 5 5 1
1 1 1 1 1 1 1 1 1 1